NO ./path_to_the_north_texture
SO ./path_to_the_south_texture
WE ./path_to_the_west_texture
EA ./path_to_the_east_texture

F 220,100,0
C 225,30,10

        11111 11111111111111111111
        10001 10001100000000000001
        10100100011100000000000001
        10010000000000000000000001
1111111110110000011100000000000001
1000000000010000011101111111110111
11110111110111011100000010001
111101   1001101110101001000111
110001   10001011100000010001
10000111110000001100000010001111
10000000000000N01101010010000001
11000001110101011111011110001111
11110111 1110101 101111010001
11111111 1111111 111111111111