NO ./path_to_the_north_texture
SO ./path_to_the_south_texture
WE ./path_to_the_west_texture
EA ./path_to_the_east_texture

F 220,100,0
C 225,30,10

        11111 11111111111111111111
    111110001 10001100000000000001111
    100000101110011100000000000000001
    111110000000000000000000000001111
1111111110110000011100000000000001
1000000000010000011101111111111111
11110011110111011100000010001
  1101   1001101110101001000111
111001   10001011100000010001
10000111100000001100000010001111
10000000000000N011010100111000001
1100000111010101111101111  11111
  110111 1110101 10111101111
   11111 1111111 111111111111
                        11