NO ./mandatory/textures/wall_north.xpm
SO ./mandatory/textures/wall_south.xpm
WE ./mandatory/textures/wall_west.xpm
EA ./mandatory/textures/wall_east.xpm

F 116,84,20
C 135,206,235

        11111 11111111111111111111
    111110001 10001100000000000001111
    100000101111111100000000000000001
    111110000000000100000000000001111
1111111110110000011100000000000001
1000000000010011111101111010111111
11110011110111001100000010001
  1101   1001111110101001000111
111001   10001001100000010001
10000111100000001100000010001111
100000000000000W11010100111000001
1100000111010101111101111  11111
  110111 1110101 10111101111
   11111 1111111 111111111111
                        11