NO ./textures/wall_north.xpm
SO ./textures/wall_south.xpm
WE ./textures/wall_west.xpm
EA ./textures/wall_east.xpm

F 116,84,20
C 135,206,235

        11111 11111111111111111111
    111110001 10001100000000000001111
    100000101110011100000000000000001
    111110000000000000000000000001111
1111111110110000011100000000000001
1000000000010010011101111111111111
11110011110111001100000010001
  1101   1001100110101001000111
111001   10001001100000010001
10000111100000001100000010001111
100000000000000N11010100111000001
1100000111010101111101111  11111
  110111 1110101 10111101111
   11111 1111111 111111111111
                        11