NO ./textures/wall_north.xpm
SO ./textures/wall_south.xpm
WE ./textures/wall_west.xpm
EA ./textures/wall_east.xpm

DO ./textures/door1.xpm ./textures/door2.xpm ./textures/door3.xpm ./textures/door4.xpm ./textures/door5.xpm ./textures/door6.xpm ./textures/door7.xpm ./textures/door8.xpm ./textures/door9.xpm ./textures/door10.xpm

F 116,84,20
C 135,206,235

        11111 11111111111111111111
    111110001 10001100000000000001111
    100000101112111100000000000000001
    111110000000000200000000000001111
1111111110110000011100000000000001
1000000000010012111101111010111111
11110011110111001100000010001
  1101   1001112110101001000111
111001   10001001100000010001
10000111100000001100000010001111
100000000000000N11010100111000001
1100000111010101111101111  11111
  110111 1110101 10111101111
   11111 1111111 111111111111
                        11